9 13 31
###############################
#p * *  * *   **  *         * #
# #*#*#*# #*#*# #*#*# #*# # #*#
# * **  ** * *** ***     *    #
#*# # # # # #*#*# # # #*# # # #
#   *      **    *  ***       #
# # # #*# # # # # # # #*# #*# #
#        *          *  *      #
# # # # # #*#*#*# # # #*#*# # #
#       ** *        **  *   * #
# #*# #*#*# # #*# # # #*# # # #
#  *   *     * *        *  *  #
###############################

