8 13 31
###############################
#p    *  *   **  * *  **  4  *#
# #*# # # #5#*# # # # # # # #*#
#  * *    *  * * 4* *   ** * *#
# #*# # #5# # # # #*# #*# # # #
#**   *       * * * *   *     #
# # # # # # # # # # #*# # # # #
#**   *            *   **  4 *#
# # # # # #*#*# # # # # # # # #
#**   **       **   ** 4 * *  #
# # # # #*#*#*#*#*# # # # # # #
#   **  ***   *  * **  2      #
###############################
