6 13 31
###############################
#p  ** *  **     2   *  *5*** #
# # # #*# # # # # # # #*# #*# #
#   *  * *   *      *  *      #
# # #*#*#*# # # #*# # # # # # #
#      ***                    #
# # # #*#*# # # # # # # # #*#*#
#   ** *     5         ****   #
# # # # #*#*# # # # # # #*# # #
#*       *** **     **       *#
# #*# # # #*# #*# # # #*# # # #
#** *  4* *  2* * *4***    5  #
###############################
