3 13 31
###############################
#p    w  * s    *   3    *2  *#
# #*# # # # # # # # # # # # # #
#    f    * w   * f  *   *   *#
# # # # # # # # # # # # #*# # #
#    *     *    w  *   1      #
# # #*# # # #*#*# # # # # # #*#
#  b *   *x    *  3  *    3   #
# # # # # # # # # # # # #*# # #
#  *   *2  *    *      *      #
# # # # # #*# #*# # # #*# # # #
#  *  w *    * 1     *   x    #
###############################
