3 13 31
###############################
#p   **        1 **        2 *#
# # # # # # # # # #*#*# # # # #
# *        * *  *  *  *      5#
#*#*# # # # # # # # # # # # #*#
#  *                 **       #
#*# # # # # # # # # #*# #*# # #
# * ** *    *       1   *     #
# #*#*#*#*# #2#*#*# #*# # # # #
#     ***     **    *  5*     #
# # # #*#*#*#*#*# # #*# # # # #
# *       ******* **       1  #
###############################
