5 13 31
###############################
#p    *  **  2*  *  **   4    #
# #*# # #*# # #*# # #*# # #*# #
#   ***  *****5*    * **      #
# # # # # # # # #*# # # # # # #
#       *   **   *** 5      * #
# # # # # #*# # # # # #*# # # #
#***            ******      **#
# # # # # # # # # # # #*#*# # #
#*             2 *    *    *  #
#*#*# # # # # # # #*# # # # #*#
# *     *   2 *   4 *    * ** #
###############################
