15 13 31
###############################
#p   ** ***  ****    ***  ** #
# # #*#*#*# #*#*# #*#*#5# # # #
#* **   *** ** *          *5*3#
# # # # #*# #*# # # #*# # # # #
#*  *   2      *4  *        * #
#*# # # # # # # #*# # # # # # #
#** ** **   3   ******5*      #
# #*#*# # # # # # #*#3# # # # #
#   *   3 **** **    * ***    #
# # # # #*#*# #*# # # #*# #*#*#
#       *55***  ***           #
###############################

