12 13 31
###############################
#p    **  * *  * **    *      #
# # #*#*# # #*#*# # # # # # # #
#*  *   * *  *   *    *  *  * #
#*#*# # #*# # # #*# # # # # #*#
#*   **  *       **   *  *    #
#*#*# #*# #*# # # #*#*# # # # #
# * *          *            * #
# # # # # #*# # # #*# # #*#*# #
#** ****  *    *              #
# # #*# # #*#*#*# #*# #*# # #*#
#    *  ****** ****     *    *#
###############################

