13 13 31
###############################
#p  ****** *  **           *  #
# # # #*# #*# # # #*#*#*# # # #
#     *    * *  * *    5 * *  #
# # #*#*# # # # #*# #*# #*# # #
#**  **            ****5      #
#*# #*#*# # #*#5# # # # # #*# #
#   *   * *           *** ** *#
# #*# # #*# #*# # # #*# # # #*#
#       *** * ***    *5*  ** 5#
#*# # #*#*# # # #*# # # # # # #
#  *  **3 *   3**   *     *4* #
###############################

