7 13 31
###############################
#p  *   *    *    * *****  *  #
# # # # # #*#*# # # # # # # #*#
# **** *  ** 4**        * **  #
# # # # # #*# # #*# # # # #*#5#
#  *           3  **  *       #
#*#*# #*# # # # # #*# #2# # #*#
#*  *     *   55** * 23*      #
# # # # # # # #*# # #*# #*# # #
#  *  *  * **  *   * *      * #
# # # # #*#*# #*#*# # # # # # #
#        *  **   ***      3   #
###############################
