15 13 31
###############################
#p   ** ***  ***              #
# # #*#*#*# #*#*# # # # # # # #
#* **   *** ** *              #
# # # # #*# #*# # # # # # # # #
#*  *          *              #
#*# # # # # # # # # # # # # # #
#** ** **                     #
# #*#*# # # # # # # # # # # # #
#   *     **** *              #
# # # # #*#*# #*# # # # # # # #
#       *  ***                #
###############################

