9 13 31
###############################
#p * *  * *3  **  *     2   * #
# #*#*#*# #*#*# #*#*# #*# # #*#
# * **  ** * *** ***     *    #
#*# # # # # #*#*# # # #*# # # #
#   *    1 **  2 *  ***       #
# # # #*# # #2# # # # #*#5#*# #
#        *          * 4*      #
# # # # # #*#*#*# # # #*#*# # #
#       ** *        **  *   * #
# #*# #*#*# # #*# # # #*# # # #
#  *   *     * *        *  *  #
###############################

