9 13 31
###############################
#p * *  * *3  **  *     4   * #
# #*#*#*# #*#*# #*#*# #*# # #*#
# * **  ** * *** ***     *    #
#*# # # # # #*#*# # # #*# # # #
#   *    4 **  4 *  ***       #
# # # #*# # #2# # # # #*#5#*# #
#        *          * 4*      #
# # # # # #*#*#*# # # #*#*# # #
#       ** *        **  *   * #
# #*# #*#*# # #*# # # #*# # # #
#  *   *     * *        *  *  #
###############################

