11 13 31
###############################
#p    * *  **   ***  * * *    #
# #*# # # # # # #3# # #*#*# #*#
#*     4 * **        *  *    5#
#*# # #*# # #2#*#5# # # # #*# #
# **  *   * ** * **     2    *#
#*# # # # # # # #*#*# # # # # #
#* *            **** 5*     * #
# # #*# # # # #*#*#5#*# #3#*# #
#  * ***      *  *            #
# # # # #*#*#*#*#*# #*# #*#*# #
#   *   *  **5*** 3*   * *    #
###############################

