10 13 31
###############################
#p    *   ** *** *    *    *  #
# # #*# #*# # #*#*#*# # # # # #
#    *  ***** **   * * **    3#
# #*# #*# # #*#*#*#*#*# # # # #
#    4 *          *4***  3*   #
# # # # # # # # # # # #*#*# # #
#   * *         2    * **  *  #
# # # # #*#*# #*# # #*#*#*#*# #
#       * ** ***  5 *  *  *  *#
# # #*# # #*# #*# # # # # # # #
#        *    3 * * *  3      #
###############################

