2 13 31
###############################
#p    * ***    *   *     *   *#
# # # # #*# # #*#*# # # # # # #
#   *    ***** * ***          #
# # #*# # # #*# #*# #*#*# #*# #
#   *         ****  ****      #
# # # # # # # # # # # # #*# #*#
#                       * *   #
# # # # # # # # # # # # #*#*# #
#       *     *  *  **     *  #
# #*# # # # # # #*# # # # #*# #
#      *  *     *       *  *  #
###############################
