6 13 31
###############################
#p  ** *  **     2   *  *4*** #
# # # #*# # # # # # # #*# #*# #
#   *  * *   *      *  *      #
# # #*#*#*# # # #*# # # # # # #
#      ***                    #
# # # #*#*# # # # # # # # #*#*#
#   ** *     4         ****   #
# # # # #*#*# # # # # # #*# # #
#*       *** **     **       *#
# #*# # # #*# #*# # # #*# # # #
#** *  4* *  2* * *4***    4  #
###############################
