8 13 31
###############################
#p    *  *   **  * *  **  5  *#
# #*# # # #5#*# # # # # # # #*#
#  * *    *  * * 5* *   ** * *#
# #*# # #5# # # # #*# #*# # # #
#**   *       * * * *   *     #
# # # # # # # # # # #*# # # # #
#**   *            *   **  4 *#
# # # # # #*#*# # # # # # # # #
#**   **       **   ** 3 * *  #
# # # # #*#*#*#*#*# # # # # # #
#   **  ***   *  * **  2      #
###############################
