14 13 31
###############################
#p    ***** ******       *   *#
# # # # #*# # # #*#*# # # #*# #
#* *   ***      *  * *  *     #
#*# #*# #*# # # # #*#*# # # # #
#    *             ** ** **   #
# #*# #*# # # # # # # # #*#*# #
#   **  *          *  ** * * *#
# # # # # # #*# # # # #*# # # #
# *     **   ***       ****   #
# # # #*#*# # #*# # # #*# # # #
#* * * * * *   *** * *  **    #
###############################

