5 13 31
###############################
#p    *  **   *  *  ** 1      #
# #*# # #*# # #*# # #*# # #*# #
#   ***  ***** * 1  * **  2    #
# # # # # # # # #*# # # # # # #
#       *   ** 3 *** 2      * #
# # # # # #*# # # # # #*# # # #
#***            ******  1   **#
# # # # # # # # # # # #*#*# # #
#*               * 1  *    *  #
#*#*# # # # # # # #*# # # # #*#
# *     *     *  1  *  3 * ** #
###############################
