8 13 31
###############################
#p    *  *   **  * *  **     *#
# #*# # # # #*# # # # # # # #*#
#  * *    *  * *  * *   ** * *#
# #*# # # # # # # #*# #*# # # #
#**   *       * * * *   *     #
# # # # # # # # # # #*# # # # #
#**   *            *   **    *#
# # # # # #*#*# # # # # # # # #
#**   **       **   **   * *  #
# # # # #*#*#*#*#*# # # # # # #
#   **  ***   *  * **         #
###############################
