3 13 31
###############################
#p       * s    *        *2  *#
# #*# # # # # # # # # # # # # #
#    f    *     * f  *   *   *#
# # # # # # # # # # # # #*# # #
#    *     *       *   1      #
# # #*# # # #*#*# # # # # # #*#
#  b *   *x    *     *        #
# # # # # # # # # # # # #*# # #
#  *   *2  *    *      *      #
# # # # # #*# #*# # # #*# # # #
#  *    *    * 1     *   x    #
###############################
