14 13 31
###############################
#p    ***** ******       *   *#
# # # # #*# # # #*#*# # # #*# #
#* *   *** 2  3 *  * *  * 3   #
#*# #*# #*# # # # #*#*# # # # #
#    *             ** ** **3  #
# #*# #*# # # # # # # #5#*#*# #
#   **  *       3  *  ** *3* *#
# # # # # # #*# # # # #*# # # #
# *     **   *** 5     **** 3 #
# # # #*#*# # #*# # # #*# # # #
#* * * *5* *   ***3* *  **3   #
###############################

