12 13 31
###############################
#p    **  *3*  * **    *  3   #
# # #*#*# # #*#*# # # # # # # #
#*  *   *3*  *   *    * 4*  * #
#*#*# # #*## # #*# # # # # #*#
#*   ** 3*   3   **   *  *    #
#*#*# #*# #*# # # #*#*# # # # #
# * *          *      5     * #
# # # # # #*# # # #*# # #*#*#5#
#** ****  *    *2             #
# # #*# # #*#*#*# #*# #*# # #*#
#    *  ******5****     *    *#
###############################

