3 13 31
###############################
#p   **         1**     3    *#
# # # # # # # # # #*#*# # # # #
# *        * *  *  *  *  3    #
#*#*# # # # # # # # # # # # #*#
#  *            2    **       #
#*# # # # # # # # # #*# #*# # #
# * ** *         1      *     #
# #*#*#*#*# # #*#*# #*# # # # #
#     ***    2**    *   * 2   #
# # # #*#*#*#*#*# # #*# # # # #
# *       ******* **   1      #
###############################
