2 13 31
###############################
#p         f   **    2  *     #
# #*# # # # # #*# # # # # # # #
#  **     *    x*    *   *    #
# # # # # # # # # # # # #*# # #
#    f     *       *   2      #
# # #*# # # #*#*# # #*# # # #*#
#    *     b   *  3   *    3  #
# # # # # # # # # # # # #*# # #
#  s    **      *  2     x    #
# # # # # #*# #*# # # #*# # # #
#  *    *  3 *       *     1  #
###############################
