4 13 31
###############################
#p    *   * **  ***  **   4   #
# # #*# #*# # #*# # # # # # # #
# ** *  * *  * *     *  * *   #
# # # # # # # # # # # # # # #*#
#            * ** *     *    *#
# # # # # #*# # #*#*#*# # # # #
# *              * * * * *4 **#
# # #5# # # # # # # # #*# # # #
#   *   4   ***               #
# # # # #*#5# #*#*#*# # #*# # #
#* **2 1*  *    * *   *       #
###############################
