2 13 31
###############################
#p    * ***    *   *    1*   *#
# # # # #*# # #*#*# # # # # # #
#   *    ***** * ***          #
# # #*# # # #*# #*# #*#*# #*# #
#   *         ****  ****      #
# # # # # # # # # # # # #*# #*#
#                       *5*   #
# # # # # # # # # # # # #*#*# #
#     5 *     *  *  **    3* 2#
# #*# # # # # # #*# # # # #*# #
#  5   *  *    2*      1*  * 1#
###############################
