4 13 31
###############################
#p    *   * **  ***  **       #
# # #*# #*# # #*# # # # # # # #
# ** *  * *  * *     *  * * 44#
# # # # # # # # # # # # # # #*#
#            * ** *     *    *#
# # # # # #*# # #*#*#*# # # # #
# *              * * * * *5 **#
# # #5# # # # # # # # #*# # # #
#   *       ***               #
# # # # #*# # #*#*#*# # #*# # #
#* **2 1*  *    * *   *       #
###############################
