4 13 31
###############################
#p    *   * **  ***  **  2    #
# # #*# #*# # #*# # # # # # # #
# ** *  * *  * *  1  *  * * 3 #
# # # # # # # # # # # # # # #*#
#            * ** *     *    *#
# # # # # #*# #1#*#*#*# # # # #
# *              * * * * *  **#
# # # # # # # # # # # #*# # # #
#   *       ***  3        1   #
# # # # #*# # #*#*#*# # #*# # #
#* ** 1 *  *    * * 1   * * 2 #
###############################
