3 13 31
###############################
#p       * s    *   3    *2  *#
# #*# # # # # # # # # # # # # #
#    f    *     * f  *   *   *#
# # # # # # # # # # # # #*# # #
#    *     *       *   1      #
# # #*# # # #*#*# # # # # # #*#
#  b *   *x    *  3  *    3   #
# # # # # # # # # # # # #*# # #
#  *   *2  *    *      *      #
# # # # # #*# #*# # # #*# # # #
#  *    *    * 1     *   x    #
###############################
