5 13 31
###############################
#p x  *  **   *  *  **        #
# #*# # #*# # #*# # #*# # #*# #
#   ***  ***** *    * **       #
# # # # # # # # #*# # # # # # #
#       *   **   ***        * #
# # # # # #*# # # # # #*# # # #
#***            ******      **#
# # # # # # # # # # # #*#*# # #
#*               *    *    *  #
#*#*# # # # # # # #*# # # # #*#
# *     *     *     *    * ** #
###############################
