4 13 31
###############################
#p    *   * **  ***  **   5   #
# # #*# #*# # #*# # # # # # # #
# ** *  * *  * *     *  * *   #
# # # # # # # # # # # # # # #*#
#            * ** *     *    *#
# # # # # #*# # #*#*#*# # # # #
# *              * * * * *5 **#
# # #5# # # # # # # # #*# # # #
#   *   4   ***               #
# # # # #*#5# #*#*#*# # #*# # #
#* **2 1*  *    * *   *       #
###############################
