2 13 31
###############################
#p  x * ***    *   *    1*   *#
# # # # #*# # #*#*# # # # # # #
#   *    ***** * ***          #
# # #*# # # #*# #*# #*#*# #*# #
#   *         ****  ****      #
# # # # # # # # # # # # #*# #*#
#                       * *   #
# # # # # # # # # # # # #*#*# #
#       *     *  *  **     * 2#
# #*# # # # # # #*# # # # #*# #
#      *  *    2*      1*  * 1#
###############################
