2 13 31
###############################
#p     w   f   **    2  *     #
# #*# # # # # #*# # # # # # # #
#  **  w  *    x*    *   *    #
# # # # # # # # # # # # #*# # #
#    f     *  w    *   2      #
# # #*# # # #*#*# # #*# # # #*#
#    *     b   *  3   *    3  #
# # # # # # # # # # # # #*# # #
#  s    **      *  2     x    #
# # # # # #*# #*# # # #*# # # #
#  *    *  3 *   w   *     1  #
###############################
